3333333333333333333333333333333333333333333333333333333333333333333333333333333
3111111111111111111000011111111000001111111111110000011111111111000000110000003
3100000000000000000110000000111110000000000000001110001000111110002111111100003
3100000000000200000111000000011100000000000000001110002000111111111110000000003
3120000000000000000111000000000000111000000000000011000000111100000000000020003
3100000002000000000111111000000000111000002000001111000000011000000111111000003
3111111111111111111110111200000010111001111111111111111100000000011111111111113
3101111000001111100000111110000000111110000001111000100000000000111111110002003
3101001000001000100000001000000000*01000000001000021100000000000000011111100003
3111111001110201100001111021010001111011110011101111100011111110000000001111113
3100001000001000100000001000000000001000000001000000100000011111100000011110003
3101111000001111100000111110000021111110000001111102100000000001111111111111113
3111111111111111111111111111111110000200000000000000000000000001111110001111113
3111111111110000000011000000000000000000000000000000000000001111110020000001113
3110020000200011002111000000110000100000000000110000100000011100000000000111113
3110000111111000000000001000001000001000001000001000100000010000001111111110003
3111111111111111111000011110002000001111111111110000011111100000000000011111113
3333333333333333333333333333333333333333333333333333333333333333333333333333333

