33333333333333333333
31111111111111111113
31000020000000000013
31000900000002000013
31200000000000000013
31000000020000000013
31111111111111111113
33333333333333333333
